11111111111111111111111111111111
1..............................1
1..............................1
1..............................1
1..............................1
1.....11111111111111111111.....1
1.....1.............w..WW1.....1
1.....1........C....w..WW1.....1
1.....1.............w..WW1.....1
1.....1.............w..WW1.....1
1.....1.............w..WW1.....1
1.....1.P...........w..WW1.....1
1.....1.............w..WW1.....1
1.....1.............w..WW1.....1
1.....1.............w..WW1.....1
1.....1........C....w..WW1.....1
1.....1.............w..WW1.....1
1.....11111111111111111111.....1
1..............................1
1..............................1
1..............................1
1..............................1
1..............................1
11111111111111111111111111111111