11111111111111111111111111111111
111........11.................11
111............................1
111...1...111..................1
1...........1..................1
1.....1.............1
1.....1...............1.......1
1...P.1....C..........1.......1
1.....1...............1.......1
1.....1...............1.......1
1.....1........................1
1.....1........11......C.......1
1.....1........11..............1
1.....1........................1
1.....1.1..............1.......1
1.....1.1.....C........1.......1
1.....1.1..............1.......1
1.....1.1..............1.......1
1.....1.11111......11111.......1
1.....1
1.....111111
1......11111
1.....M....1
111111111111